
# Chapter SLE

   (p2 Subsection LA) :: math.la.d.lineqn
Definition SLE :: math.la.d.linsys
Definition SSLE :: math.la.d.linsys.soln
Definition SSSLE :: math.la.d.linsys.soln_set

Definition ESYS :: math.la.d.linsys.equiv
Definition EO :: math.la.d.linsys.op
Theorem EOPSS :: math.la.t.linsys.op

Definition M :: math.la.d.mat, math.la.d.mat.m_by_n, math.la.c.mat.entry,
Definition CV :: math.la.d.vec.col.coord, math.la.d.vec.size.coord, math.la.d.vec.coord, math.la.d.vec.component.coord
Definition ZCV :: math.la.d.vec.z.coord
Definition CM :: math.la.d.mat.coeff
Definition VOC :: math.la.d.mat.constant
Definition SOLV :: math.la.d.vec.solution
Definition MRLS :: math.la.d.linsys.mat.repn
Definition AM :: math.la.d.mat.augmented
Definition RO :: math.la.d.mat.row_op
Definition REM :: math.la.d.mat.row_op .d.mat.row_equiv
Theorem REMES :: math.la.t.mat.row_equiv.linsys
Definition RREF :: math.la.d.mat.rref
  (+p[conclusion?]: pivot column) :: math.la.d.mat.pivot_col
Theorem REMEF :: math.la.t.mat.rref.exists
Theorem RREFU :: math.la.t.mat.rref.unique

Definition CS :: math.la.d.linsys.consistent, math.la.d.linsys.inconsistent
Definition IDV :: math.la.d.linsys.variable.dependent, math.la.d.linsys.variable.independent
Theorem RCLS :: math.la.t.rref.consistent
Theorem CSRN :: math.la.t.rref.pivot
Theorem FVCS :: math.la.t.rref.pivot.free
Theorem PSSLS :: math.la.t.linsys.zoi
Theorem CMVEI :: math.la.t.linsys.consistent.i

Definition HS :: math.la.d.linsys.homog
Theorem HSC :: math.la.d.linsys.homog.consistent
Definition TSHSE :: math.la.d.linsys.homog.trivial
Theorem HMVEI :: math.la.t.linsys.homog.i
Definition NSM :: math.la.d.mat.null_space.right

Definition SQM :: math.la.d.mat.square
Definition NM  :: math.la.d.mat.nonsingular.z, math.la.d.mat.singular
Definition IM :: math.la.d.mat.identity
Theorem NMRRI :: math.la.t.equiv.identity
Theorem NMTNS :: math.la.t.equiv.nullspace
Theorem NMUS :: math.la.t.equiv.mat.eqn.unique
Theorem NME1 :: math.la.t.equiv.identity.rep, math.la.t.equiv.nullspace.rep, math.la.t.equiv.mat.eqn.unique.rep

# Chapter V
\chap V Vectors

\sec VO Vector Operations

\ssec CV Column Vectors
Definition VSCV :: math.la.d.vec.rncn
Definition CVE :: math.la.d.vec.equal.coord
Definition CVA :: math.la.d.vec.sum.coord
Definition CVSM :: math.la.d.vec.scalar.mult.coord

\ssec VSP Vector Space Properties
Theorem VSPCV :: math.la.t.vec.axioms.rncn

\sec LC Linear Combinations

\ssec LC Linear Combinations
Definition LCCV :: math.la.d.vec.lincomb.coord
Theorem SLSLC :: math.la.t.mat.eqn.lincomb

\ssec VFSS Vector Form of Solution Sets
Theorem VFSLS :: math.la.t.linsys.soln.vector

\ssec PSHS Particular Solutions, Homogeneous Solutions
Theorem PSPHS :: math.la.t.linsys.nonhomog.particular_plus_homog

\sec SS Spanning Sets

\ssec SSV Span of a Set of Vectors

Definition SSCV :: math.la.d.vec.span.coord

\ssec SSV Span of a Set of Vectors
Definition SSCV :: math.la.d.vec.span.coord

\ssec SSNS Spanning Sets of Null Spaces
114 Theorem SSNS :: math.la.t.mat.null_space.rref.span

\sesc LI Linear Independence

\ssec LISV Linearly Independent Sets of Vectors
Definition RLDCV :: math.la.d.vec.lindep.relation, math.la.d.vec.lindep.relation.trivial
Definition LICV :: math.la.d.vec.linindep.coord
Theorem LIVHS :: math.la.t.vec.linindep.homog
Theorem LIVRN :: math.la.t.vec.linindep.pivot
Theorem MVSLD :: math.la.t.vec.lindep.more.rncn

\ssec LINM Linear Independence and Nonsingular Matrices
Theorem NMLIC :: math.la.t.equiv.col.linindep
129 Theorem NME2 :: math.la.t.equiv.col.linindep.rep

\ssec NSSLI Null Spaces, Spans, Linear Independence
Theorem BNS :: math.la.t.mat.null_space.rref.basis  [[ basis not actually defined yet ]]

\sec LDS Linear Dependence and Spans

\ssec LDSS Linearly Dependent Sets and Spans
Theorem DLDS :: math.la.t.vec.lindep.coord

\ssec COV Casting Out Vectors
147 Theorem BS :: math.la.t.vsp.span.basis.rref, math.la.t.vsp.span.basis

\sec O Orthogonality

\ssec CAV Complex Arithmetic and Vectors
Definition CCCV :: math.la.d.vec.conjugate.cn
Theorem CRVA :: math.la.t.vec.sum.conjugate.cn
Theorem CRSM :: math.la.t.vec.scalar.mult.conjugate.cn

\ssec IP Inner products
Definition IP :: math.la.d.innerproduct.cn
Theorem IPVA :: math.la.t.innerproduct.distributive.rncn
Theorem IPSM :: math.la.t.innerproduct.commutative.scalar.cn
Theorem IPAC :: math.la.t.innerproduct.commutative.cn

\ssec N Norm
Definition NV :: math.la.d.vec.norm.coord
Theorem IPN :: math.la.t.vec.innerproduct.norm
Theorem PIP :: math.la.t.innerproduct.self.positive.coord, math.la.t.innerproduct.self.z.coord

\ssec OV Orthogonal Vectors
Definition OV :: math.la.d.vec.orthogonal.coord
Definition OSV :: math.la.d.vec.orthogonal_set
Definition SUV :: math.la.d.vsp.basis.standard.rncn, math.la.d.vec.unit.coord [[ unit not actually defined ]]
Theorem OSLI :: math.la.t.vec.orthogonal_set.linindep

\ssec GSP Gram-Schmidt Procedure
Theorem GSP :: math.la.d.gramschmidt, math.la.t.gramschmidt
Definition ONS :: math.la.d.vec.orthonormal_set

\chap M Matrices

\sec MO Matrix Operations

\ssec MEASM Matrix Equality, Addition, Scalar Multiplication
DefinitionVSM :: math.la.d.mat.m_by_n.set   [[ called vector space, but really a set ]]
Definition ME :: math.la.d.mat.equal
Definition MA :: math.la.d.mat.sum
Definition MSM :: math.la.d.mat.scalar.mult

\ssec VSP Vector Space Properties
Theorem VSPM :: math.la.e.vsp.mat.m_by_n
Definition ZM :: math.la.d.mat.z

\ssec TSM Transposes and Symmetric Matrices
Definition TM :: math.la.d.mat.transpose
Definition SYM :: math.la.d.mat.symmetric
Theorem SMS :: math.la.t.mat.symmetric.square
Theorem TMA :: math.la.t.mat.sum.transpose
Theorem TMSM :: math.la.t.mat.scalar.transpose
Theorem TT :: math.la.t.mat.transpose.involution

\ssec MCC Matrices and Complex Conjugation
Definition CCM :: math.la.d.mat.conjugate
Theorem CRMA :: math.la.t.matsum.conjugate
Theorem CRMSM :: math.la.t.mat.scalar.conjugate
Theorem CCM :: math.la.t.mat.conjugate.involution
Theorem MCT :: math.la.t.mat.transpose.conjugate

\ssec AM Adjoint of a Matrix
Definition A :: math.la.d.mat.adjoint
Theorem AMA :: math.la.t.mat.sum.adjoint
Theorem AMSM :: math.la.t.mat.scalar.adjoint
Theorem AA :: math.la.t.mat.adjoint.involution
Exercise T30 :: math.la.d.mat.skewsymmetric

\sec MM Matrix Multiplication

\ssec MVP Matrix-Vector Product
Definition MVP :: math.la.d.mat.vec.prod
Theorem SLEMM :: math.la.t.mat.eqn.linsys
Theorem EMMVP :: math.la.t.mat.vec.prod.unique

\ssec MM Matrix Multiplication
Definition MM :: math.la.d.mat.mult.col

\ssec MMEE Matrix Multiplication, Entry-by-Entry
Theorem EMP :: math.la.t.mat.mult.coord

\ssec PMM Properties of Matrix Multiplication
Theorem MMZM :: math.la.t.mat.mult.z
Theorem MMIM :: math.la.t.mat.mult.identity
Theorem MMDAA :: math.la.t.mat.mult.distributive
Theorem MMSMM :: math.la.t.mat.scalar.prod.commut
Theorem MMA :: math.la.t.mat.mult.assoc
Theorem MMIP :: math.la.t.innerproduct.mat.cn
Theorem MMCC :: math.la.t.mat.mult.conjugate

Theorem MMT :: math.la.t.mat.mult.transpose
Theorem MMAD :: math.la.t.mat.mult.adjoint

\ssec HM Hermitian Matrices
Theorem AIP :: math.la.t.innerproduct.adjoint.cn
Definition HM :: math.la.d.mat.hermitian
Theorem HMIP :: math.la.d.mat.hermitian.innerproduct.cn

\sec MISLE
Matrix Inverses and Systems of Linear Equations

\ssec SI Solutions and Inverses

\ssec IM Inverse of a Matrix
Definition MI :: math.la.d.mat.inv, math.la.d.mat.invertible

\ssec CIM Computing the Inverse of a Matrix
Theorem TTMI :: math.la.t.mat.inv.2x2
Theorem CINM :: math.la.t.mat.inv.augmented

\ssec PMI Properties of Matrix Inverses
Theorem SS :: math.la.t.mat.inv.shoesandsocks
Theorem MIMI :: math.la.t.mat.inv.involution
Theorem MIT :: math.la.t.mat.inv.transpose
Theorem MISM :: math.la.t.mat.inv.scalar

\sec MINM Matrix Inverses and Nonsingular Matrices

\ssec NMI Nonsingular Matrices are Invertible
Theorem NPNT :: math.la.t.mat.prod.nonsingular
Theorem OSIS :: math.la.t.mat.inv.oneside
Theorem NI :: math.la.t.equiv.inv
Theorem SNCM :: math.la.t.eqn.mat.inv

\ssec UM Unitary Matrices
Definition UM :: math.la.d.mat.unitary
Theorem UMI :: math.la.t.mat.unitary.inv
Theorem CUMOS :: math.la.t.mat.unitary.col.orthogonal
Theorem UMPIP :: math.la.t.mat.unitary.innerproduct

\sec CRS Column and Row Spaces

\ssec CSSE Column Spaces and Systems of Equations
Definition CSM :: math.la.d.mat.col_space
Theorem CSCS :: math.la.t.mat.eqn.lincomb

\ssec CSSOC Column Space Spanned by Original Columns
Theorem BCS :: math.la.t.mat.col_space.pivot  [[ basis still not defined ]]

\ssec CSNM Column Space of a Nonsingular Matrix
Theorem CSNM :: math.la.t.equiv.col.span

\ssec RSM Row Space of a Matrix

Definition RSM :: math.la.d.mat.row_space
Theorem REMRS :: math.la.d.mat.row_space.row_equiv
Theorem BRS :: math.la.t.mat.row_space.pivot [[ why say nonzero columns of the transpose instead of nonzero rows ?]]
[[ Theorem CSRST :: omitting.because.trivial ]]

\sec FS Four Subsets

\ssec  LNS Left Null Space
Definition LNS :: math.la.d.mat.null_space.left

\ssec CCS Computing Column Spaces

\ssec EEF Extended Echelon Form
Definition EEF :: math.la.d.mat.erref.of
Theorem PEEF :: math.la.t.mat.erref.of

\ssec FS Four Subsets
244 Theorem FS :: math.la.t.mat.erref.spaces
On page 254 :: math.la.c.mat.col_space.row_reduce

\chap VS Vector Spaces

\sec VS Vector Spaces

\ssec VS Vector Spaces
Definition VS :: math.la.d.vec.add.arb, math.la.d.vec.scalar.mult.arb, math.la.d.vsp.axioms.arb, math.la.d.vec.arb
In text :: math.foundation.d.axiom
Example VSCV :: math.la.e.vsp.cn
Example VSM :: math.la.e.vsp.mat.m_by_n
Example VSP :: math.la.e.vsp.polynomial.leq_n
Example VSIS :: math.la.e.vsp.sequence
Example VSF :: math.la.e.vsp.function
Example VSS :: math.la.e.vsp.z
Example CVS :: math.la.e.vsp.crazy

\ssec VSP Vector Space Properties
Theorem ZVU :: math.la.t.vsp.z.unique
Theorem AIU :: math.la.d.vsp.vector.negative.unique
Theorem ZSSM :: math.la.t.vsp.scalar.mult.z
Theorem ZVSM :: math.la.t.vsp.vector.mult.z
Theorem AISM :: math.la.t.vsp.vector.negative

Theorem SMEZV :: math.la.t.vsp.mult.z

\ssec RD Recycling Definitions

\sec S Subspaces

\ssec S Subspaces
Definition S :: math.la.d.vsp.subspace.arb

\ssec TS Testing Subspaces
Theorem TSS :: math.la.t.vsp.subspace.lincomb.arb
Definition TS :: math.la.d.vsp.subspace.z.arb
Theorem NSMS :: math.la.t.mat.null_space.rncn

\ssec TSS The Span of a Set
Definition LC :: math.la.d.vec.lincomb.arb
Definition SS :: math.la.d.vec.span.arb
Theorem SSS :: math.la.t.vec.span.subspace.arb

\ssec SC Subspace Constructions
Theorem CSMS :: math.la.e.vsp.row
Theorem RSMS :: math.la.e.vsp.col
Theorem LNSMS :: math.la.t.mat.null_space.left.rncn

\sec LISS Linear Independence and Spanning Sets

\ssec LI Linear Independence
Definition RLD :: math.la.d.vec.lindep.relation.rep, math.la.d.vec.lindep.relation.trvial.rep
Definition LI :: math.la.d.vec.linindep.arb

\ssec SS Spanning Sets
Definition SSVS :: math.la.d.vsp.span.set.arb

\ssec VR Vector Representation
Theorem VRRB :: math.la.t.vsp.basis.coord.unique  [[ basis still not defined? ]]

\sec B Bases

\ssec B Bases
Definition B :: math.la.d.vsp.basis.arb
Theorem SUVB :: math.la.t.vsp.basis.standard.rncn
Example BP :: math.la.d.vsp.basis.standard.leq_n
Example BM :: math.la.d.vsp.basis.standard.m_by_n

\ssec BSCV Bases for Spans of Column Vectors

\ssec BNM Bases and Nonsingular Matrices
Theorem CNMB :: math.la.t.equiv.col.basis

\ssec OBC Orthonormal Bases and Coordinates
Theorem COB :: math.la.t.subspace.basis.orthogonal
Theorem UMCOB :: math.la.t.mat.unitary.basis.orthogonal

\sec D Dimension

\ssec D Dimension
Definition D :: math.la.d.vsp.dim.arb, math.la.d.vsp.dim.finite_infinite.arb
Theorem SSLD :: math.la.t.vsp.dim.more.lindep.arb
Theorem BIS :: math.la.t.vsp.dim.arb

\ssec DVS Dimension of Vector Spaces
[[ examples of dimensions of spaces omitted ]]

\ssec RNM Rank and Nullity of a Matrix
Definition NOM :: math.la.d.mat.nullity
Definition ROM :: math.la.d.mat.rank
Theorem CRN :: math.la.t.mat.rank.pivot
Theorem RPNC :: math.la.t.mat.ranknullity

\ssec RNNM Rank and Nullity of a Nonsingular Matrix
Theorem RNNM :: math.la.t.equiv.rank, math.la.t.equiv.nullity

\sec PD Properties of Dimension

\ssec GT Goldilocks' Theorem
Theorem ELIS :: math.la.t.vsp.linindep.extend
Theorem G :: math.la.t.vsp.dim.more.lindep.arb, math.la.t.vsp.dim.less.span.arb, math.la.t.vsp.dim.span.linindep.arb
Theorem PSSD :: math.la.t.vsp.subspace.dim.arb
Theorem EDYES :: math.la.t.vsp.subspace.dim.equal

\ssec RT Ranks and Transposes
Theorem RMRT :: math.la.t.mat.row_space.col_space [[ said very differently ]]

\ssec DFS Dimension of Four Subspaces
Theorem DFS :: math.la.t.mat.erref.dimension

\chap D Determinants

\sec DM Determinant of a Matrix

\ssec EM Elementary Matrices
Definition ELEM :: math.la.d.mat.elementary
Theorem EMDRO :: math.la.t.mat.mult.elementary
Theorem EMN :: math.la.d.mat.elementary.inv
Theorem NMPEM :: math.la.d.mat.elementary.prod

\ssec DD Definition of the Determinant
Definition SM :: math.la.d.mat.cofactor
Definition DM :: math.la.d.mat.det.cofactor
Theorem DMST :: math.la.t.mat.det.2x2

\ssec CD Computing Determinants

Theorem DER :: math.la.t.mat.det.cofactor.row
Theorem DT :: math.la.t.mat.det.transpose
Theorem DEC :: math.la.t.mat.det.cofactor.col

\sec PDM Properties of Determinants of Matrices

\ssec DRO Determinants and Row Operations
Theorem DZRC :: math.la.t.mat.row.z
Theorem DRCS :: math.la.t.mat.det.switch
Theorem DRCM :: math.la.t.mat.det.scalar
Theorem DERC :: math.la.t.mat.row.equal
Theorem DRCMA :: math.la.t.mat.det.add_mult

\ssec DROEM Determinants, Row Operations, Elementary Matrices
[[ omit Theorem DIM ]]
Theorem DEM :: math.la.t.mat.elementary.det
[[ omit Theorem DEMMM ]]

\ssec DNMMM Determinants, Nonsingular Matrices, Matrix Multiplication
Theorem SMZD :: math.la.t.equiv.det
Theorem DRMM :: math.la.t.mat.det.product

\chap E Eigenvalues

\sec EE Eigenvalues and Eigenvectors

\ssec EEM Eigenvalues and Eigenvectors of a Matrix
Definition EEM :: math.la.d.mat.eigvec, math.la.d.mat.eig

\ssec PM Polynomials and Matrices

\ssec EEE Existence of Eigenvalues and Eigenvectors
[[ omit Theorem EMHE ]]

\ssec CEE Computing Eigenvalues and Eigenvectors
Definition CP :: math.la.d.mat.charpoly
Theorem EMRCP :: math.la.t.mat.charpoly.eig
Definition EM :: math.la.d.mat.eigsp
Theorem EMS :: math.la.t.mat.eigsp.subsp
Theorem EMNS :: math.la.t.mat.eigsp.nullspace

\ssec ECEE Examples of Computing Eigenvalues and Eigenvectors
Definition AME :: math.la.d.mat.eig.multiplicity.algebraic
Definition GME :: math.la.d.mat.eig.multiplicity.geometric

\sec PEE Properties of Eigenvalues and Eigenvectors

\ssec BPE Basic Properties of Eigenvalues
Theorem EDELI :: math.la.t.mat.eigvec.linindep

Theorem SMZE :: math.la.t.equiv.eig
Theorem ESMM :: math.la.t.mat.eig.scalar
Theorem EOMP :: math.la.t.mat.eig.power
Theorem EPM :: math.la.t.mat.eig.polynomial
Theorem EIM :: math.la.t.mat.eig.inv
Theorem ETM :: math.la.t.mat.eig.transpose
Theorem ERMCP :: math.la.t.mat.real.eig.cn

\ssec ME Multiplicities of Eigenvalues

[[ omit Theorem DCP ]]
Theorem NEM :: math.la.d.mat.eig.number
Theorem ME :: math.la.t.mat.eig.multiplicity.eigenspace
[[ omit Theorem MNEM ]]

\ssec EHM Eigenvalues of Hermitian Matrices
Theorem HMRE :: math.la.t.mat.hermitian.eig.real
Theorem HMOE :: math.la.t.mat.hermitian.eigvec.orthogonal

\sec SD Similarity and Diagonalization

\ssec SM Similar Matrices
Definition SIM :: math.la.d.mat.similar

\ssec PSM Properties of Similar Matrices
Theorem SER :: math.la.t.mat.similar.equiv
Theorem SMEE :: math.la.t.mat.similar.eig

\ssec D Diagonalization
Definition DIM :: math.la.d.mat.diagonal

Definition DZM :: math.la.d.mat.diagonalizable, math.la.d.mat.diagonalization
Theorem DC :: math.la.t.mat.diagonalizable
Theorem DMFE :: math.la.t.mat.diagonalizable.charpoly
Theorem DED :: math.la.t.mat.diagonalizable.distinct

\ssec FS Fibonacci Sequences
[[ omitted ]]

\chap LT Linear Transformations

\sec LT Linear Transformations

\ssec LT Linear Transformations
Definition LT :: math.la.d.lintrans.arb
Theorem LTTZZ :: math.la.t.lintrans.z

\ssec LTC Linear Transformation Cartoons

\ssec MLT Matrices and Linear Transformations

Theorem MBLT :: math.la.c.transformation.matrix

Theorem MLTCV :: math.la.t.lintrans.mat.basis.standard.coord

\ssec LTLC Linear Transformations and Linear Combinations

Theorem LTLC :: math.la.t.lintrans.lincomb
Theorem LTDB :: math.la.t.lintrans.basis

\ssec PI Pre-Images

Definition PI :: math.la.d.lintrans.preimage.arb

\ssec NLTFO New Linear Transformations From Old
Definition LTA :: math.la.d.lintrans.sum.arb

Theorem SLTLT :: math.la.t.lintrans.sum.arb
Definition LTSM :: math.la.d.lintrans.scalar.arb
Theorem MLTLT :: math.la.t.lintrans.scalar.arb
Theorem VSLT :: math.la.t.lintrans.vsp
Definition LTC :: math.la.d.lintrans.composition.arb
Theorem CLTLT :: math.la.t.lintrans.composition.arb

\sec ILT Injective Linear Transformations

\ssec ILT Injective Linear Transformations
Definition ILT :: math.la.d.lintrans.injective.arb

\ssec EILT Examples of Injective Linear Transformations

\ssec KLT Kernel of a Linear Transformation

Definition KLT :: math.la.d.lintrans.kernel.arb

Theorem KLTS :: math.la.t.lintrans.kernel.arb
Theorem PKI :: math.la.t.lintrans.preimage.translation.arb
Theorem KILT :: math.la.t.lintrans.equiv.kernel

\ssec ILTLI Injective Linear Transformations and Linear Independence
Theorem ILTLI :: math.la.t.lintrans.injective.linindep
Theorem ILTB :: math.la.t.lintrans.equiv.basis

\ssec ILTD Injective Linear Transformations and Dimension
Theorem ILTD :: math.la.t.lintrans.injective.dim

\ssec CILT Composition of Injective Linear Transformations
Theorem CILTI :: math.la.t.lintrans.composition.injective.arb

\sec SLT Surjective Linear Transformations

\ssec SLT Surjective Linear Transformations
Definition SLT :: math.la.d.lintrans.surjective.arb

\ssec ESLT Examples of Surjective Linear Transformations

\ssec RLT Range of a Linear Transformation
Definition RLT :: math.la.d.lintrans.range.arb
Theorem RLTS :: math.la.t.lintrans.range.subsp.arb
[[ omit Theorem RSLT ]]

\ssec SSSLT Spanning Sets and Surjective Linear Transformations
Theorem SSRLT :: math.la.t.lintrans.range.span.arb
[[ omit Theorem RPI ]]
Theorem SLTB :: math.la.t.lintrans.basis.span.surjective.arb

\ssec SLTD Surjective Linear Transformations and Dimension
Theorem SLTD :: math.la.t.lintrans.surjective.dim

\ssec CSLT Composition of Surjective Linear Transformations`
Theorem CSLTS :: math.la.t.lintrans.composition.surjective.arb

\sec IVLT Invertible Linear Transformations

\ssec IVLT Invertible Linear Transformations
Definition IDLT :: math.la.d.lintrans.identity
Definition IVLT :: math.la.d.lintrans.invertible.arb, math.la.d.lintrans.inv.arb
Theorem ILTLT :: math.la.t.lintrans.inv.arb
Theorem IILT :: math.la.t.lintrans.inv.involution.arb

\ssec IV Invertibility

Theorem ILTIS :: math.la.t.lintrans.invertible.arb
Theorem CIVLT :: math.la.t.lintrans.composition.invertible.arb
Theorem ICLT :: math.la.t.lintrans.inv.shoesandsocks

\ssec SI Structure and Isomorphism
Definition IVS :: math.la.d.vsp.isomorphism
Theorem IVSED :: math.la.t.vsp.isomorphic.dim

\ssec RNLT Rank and Nullity of a Linear Transformation
Definition ROLT :: math.la.d.lintrans.rank
Definition NOLT :: math.la.d.lintrans.nullity
Theorem ROSLT :: math.la.t.lintrans.surjective.rank
Theorem NOILT :: math.la.t.lintrans.equiv.nullity
Theorem RPNDD ::amath.la.t.lintrans.ranknullity

\ssec SLELT Systems of Linear Equations and Linear Transformations

\chap R Representations

\sec VR Vector Representations

\ssec VR Vector Representations
Definition VR :: 

########

p259, after Definiiton VS:
  A vector space is composed of three objects, a set and two operations.
  # comma should be a colon.
